1111111111
1C000100C1
1010PE0101
1C001000C1
1111111111
