11111111111111111111111111111111111111111111111111111111111111111
11111111111111111000000000000000001111111111111000000000000001111
1111111111111111100000000000C000001111111111111000000000000001111
11111111111111111000000000000000001111111111111000000000000001111
11111111111111111000000000000000001111111111111000000000000001111
11111111111111111000000000000000001111111111111000000000000001111
11111111111111111000000000000000001111111111111000000000000001111
11111111111111111000000000000000001111111111111000000000000001111
11111111111111111000000000000000001111111111111000CCC000000001111
111111111111111110000000000000000011111111111110000CCC00000001111
11111111111111111000000000000E00001111111111111000000000000001111
11111111111111111000000000000000001111111111111000000000000001111
11111111111111111000000000000000001111111111111000000000000001111
11111111111111111000000000000000000000000000000000000000000001111
11111111111111111000000000000000000000000000000000000000000001111
11111111111111111000000000E00000001111111111111000000000000001111
11111111111111111000000000000000001111111111111000000000000001111
11111111111111111000000000000000001111111111111000000000000001111
1111111111111111100000000000000000C11111111111100000000C000001111
11111111111111111000000000000000001111111111111000000000000001111
11111111111111111000000000000000001111111111111000000000000001111
11111111111111111000000000000000001111111111111000000000000001111
11111111111111111000000000000000001111111111111000000000000001111
11111111111111111000000000000000001111111111111000000000000001111
11111111111111111000000000000000001111111111111000000000000001111
11111111111111111000000000000000001111111111111000P00000000001111
11111111111111111000000000000000001111111111111000000000000001111
11111111111111111000000000000000001111111111111000000000000001111
11111111111111111000000000000000001111111111111000000000000001111
11111111111111111000000000000000001111111111111000000000000001111
11111111111111111000000000000000001111111111111000000000000001111
111111111111111110000000000E0000001111111111111000000000000001111
11111111111000000000000000000000000000000000000000000000000000001
11111111111111111111111111111111111111111111111111111111111111111
