111111111111111111111
100000000000000000001
100000000000000000001
100000000000000000001
1000C000000000000C001
100000000000000000001
100000000000000000001
100000000000000000001
100000000000000000001
1000000000P0000000001
100000000000000000001
100000000000000000001
100000000000000000001
100000000000000000001
100000000000000000001
100000000000000000001
1000C00000000000C0001
100000000000000000001
100000000000000000001
1E0000000000000000001
111111111111111111111
