1111111111
1000000001
1000000001
1001P00C01
1000100001
1000000001
100100C001
1000000001
1E00000001
1111111111
