111111111111111
10C000000000001
1C0C00000000001
100000000000001
100000001110001
1000000100C1001
10000001P111001
10000001E0C1001
100000001110001
100000000000001
111111111111111
