111111111111111
100000000000001
100000000000001
100000011100001
1000001CCC10001
1000001CPC10001
1000101CC110001
100000000C10001
10000E000000001
100000000000001
111111111111111
